1,1,1,1,1,1,1,1,1,1,1,1,1,1,1,1
1,0,0,0,0,0,0,0,0,0,0,0,0,0,0,1
1,0,0,0,0,0,0,0,0,0,0,0,0,0,0,1
1,0,0,0,0,0,0,0,0,0,0,0,0,0,0,1
1,0,0,1,1,1,1,1,1,1,1,1,0,0,0,1
1,0,0,4,4,4,3,3,3,4,4,4,0,0,0,1
1,0,0,4,4,1,0,0,0,1,4,4,0,0,0,1
1,0,0,4,4,1,0,0,0,1,4,4,0,0,0,1
1,0,0,4,4,1,0,5,0,1,4,4,0,0,0,1
1,0,0,4,4,1,0,0,0,1,4,4,0,0,0,1
1,0,0,4,4,1,1,0,1,1,4,4,0,0,0,1
1,0,0,0,0,0,0,0,0,0,0,0,0,0,0,1
1,0,0,0,0,0,0,0,0,0,0,0,0,0,0,1
1,0,0,0,0,0,1,1,1,0,0,0,0,0,0,1
1,0,0,0,0,0,1,5,1,0,0,0,0,0,0,1
1,1,1,1,1,1,1,1,1,1,1,1,1,1,1,1